Help on the Way=>Help
Slipknot!=>Slip
Franklin's Tower=>Franklin's
Uncle John's Band=>Uncle John's
Playing In The Band=>PITB
Cassidy=>Cassidy
Jack Straw=>Straw
China Cat Sunflower=>China Cat
I Know You Rider=>Rider
Scarlet Begonias=>Scarlet
Fire on the Mountain=>Fire
Estimated Prophet=>Estimated
Eyes of the World=>Eyes
The Other One=>Other One
Morning Dew=>Dew
Brown-Eyed Women=>Brown-Eyed
Mississippi Half-Step Uptown Toodeloo=>Half-Step
They Love Each Other=>TLEO
Greatest Story Ever Told=>Greatest Story
Me and My Uncle=>My Uncle
Mexicali Blues=>Mexicali
Deal=>Deal
Bertha=>Bertha
Sugar Magnolia=>Sugar Mags
Truckin'=>Truckin'
Ramble On Rose=>Ramble
Row Jimmy=>Row Jimmy
He's Gone=>He's Gone
Cumberland Blues=>Cumberland
Tennessee Jed=>Jed
U.S. Blues=>US Blues
One More Saturday Night=>Saturday Night
Shakedown Street=>Shakedown
Terrapin Station=>Terrapin
Saint of Circumstance=>Saint
Althea=>Althea
Let It Grow=>LIG
Not Fade Away=>NFA
Goin' Down The Road Feelin' Bad=>GDTRFB
Good Lovin'=>Good Lovin'
Black Peter=>Black Peter
Wharf Rat=>Wharf Rat
Stella Blue=>Stella
Ship of Fools=>Ship
Looks Like Rain=>LLR
Lost Sailor=>Sailor
Saint of Circumstance=>Saint
Sugar Magnolia=>Sugar Mags
The Wheel=>Wheel